{
  "rows": [
    "|                                                    |",
    "-----------___~~~~~___-----###------------------ -----",
    "|                          ###                       |",
    "|                          ###                 ------|",
    "|                          ###                       e",
    "--------------------------------------__~~~~~~~~~~__--"
  ],
  "start": { "x": 2, "y": 0 },
  "updateInterval": 100
}
